NO ./maps/textures/wall.xpm
SO ./maps/textures/wall_2.xpm
WE ./maps/textures/ozjfzaoij.xpm

F 100,100,100
C 0,128,255

111111111
100001001
100101001
100100001
1000N0001
100000001
100000001
111111111