NO ./textures/wall0.xpm
SO ./textures/wall1.xpm
WE ./textures/wall2.xpm
EA ./textures/wall3.xpm

F 220,100,0
C 225,30,0

1111111111
1E00000001
1111111111
