NO ./maps/wall.xpm
SO ./maps/wall.xpm
WE ./maps/wall.xpm
EA ./maps/wall.xpm

DOOR ./maps/wall.xpm

F 220,100,0
C 225,30,0

111111
1D0101
101001
100N1
1111
