NO ./maps/wall.xpm
SO ./maps/wall.xpm
WE ./maps/wall.xpm
EA ./maps/wall.xpm

DOOR ./maps/wall.xpm
F 220,100,0
C 225,30,0



111111          11111
1D0101          10001
1D0101111111    11111
1D0100000001
1D0101111111
1D0101
101N11
111111