NO ./maps/textures/wall.xpm
WE ./maps/texturezoijfd.xpm

DOOR ./maps/textures/door.xpm
RIGHT_HAND ./maps/textures/right_hand.xpm

F 220,100,0
C 225,30,0

111111
100101
101N01
10001
1111
