NO ./maps/textures/wall.xpm
WE ./maps/texturezoijfd.xpm

DOOR ./maps/textures/door.xpm
RIGHT_HAND ./maps/textures/right_hand.xpm

F 100,100,100
C 0,128,255

111111
100101
101N01
10001
1111
